* * * * * * * * * * * * * * * * * * * * * * * * * * * * * * * * * * * * * * * * * * * * * * * * * * * * * * * * *
* * * * * * * * * * * * * * * * * * * * * * * * * * * * * * * * * * * * * * O * * * * * * * * * * * * * * * * * *
* * * * * * * * * * * * * * * * * * * * * * * * * * * * * * * * * * * * * * * * * * * * * * * * * * * * * * * * *
* * * * * * * * * * * * * * * * * * * * * * * * * * G * * * * * * * * * * * O * * * * * * * * * * * * * * * * * *
* * * * * * * * * * * * * * * * * * * * * * * * * * * * * * * * * * * * * * * * * * * * * * * * * * * * * * * * *
* * * * * * * * * * * * * * * * * * * * * * * * * * * * G * * * * * * * * * O * * * * * * * * * * * * * * * * B *
* * * * * * * * * * * * * * * * * * * * * * * * * * * * * * * * * * * * * * * * * * * * * * * * * * * * * * * * *
* * * * * * * * * * * * * * * * * R * * * * * * * * * * * * G * * * * * * * O * * * * * * * * * * * * * * B * * *
* * * * * * * * * * * * * * * * * * * * * * * * * * * * * * * * * * * * * * * * * * * * * * * * * * * * * * * * *
* * * * * * * * * * * * * * * * * * * R * * * * * * * * * * * * G * * * * * O * * * * * * * * * * * * B * * * * *
* * * * * * * * * * * * * * * * * * * * * * * * * * * * * * * * * * * * * * * * * * * * * * * * * * * * * * * * *
* * * * * * * * * * * * * * * * * * * * * R * * * * * * * * * * G * G * * * O * * * * * * * * * * B * * * * * * *
* * * * * * * * * * * * * * * * * * * * * * * * * * * * * * * * * * * * * * * * * * * * * * * * * * * * * * * * *
* * * * * * * * * * * * * * * * * * * * * * * R * * * * * * * * * * * * G * * * * * * * * * * B * * * * * * * * *
* * * * * * * * * * * * * * * * * * * * * * * * * * * * * * * * * * * * * * * * * * * * * * * * * * * * * * * * *
* * * * * * * * * * * * G * * * * * * * * * * * * R * * * * * * * * * * * *O/G* * * * * * B * * * * * * * * * * *
* * * * * * * * * * G * * * G * * * * * * * * * * * * * * * * * * * * * * * * * * * * * * * * * * * * * * * * * *
* * * * * * * * * G * * * * * G * * * * * * * * * * * R * * * * B * * * * *O/G* * * * B * * * * * * * * * * * * *
* * * * * * * * G * * * * * * * G * * * * * * * * * * * * * * * * * * * * * * * * * * * * * * * * * * * * * * * *
* * * * * * * G * * * * * * * * * G * * * * * * * * * * * R * * * * *B/G* * * * * B * * * * * * * * * * * * * * *
* * * * * * G * * * * * * * * * * * G * * * * * * * * * * * * * * * * * * * * * * * * * * * * * * * * * * * * * *
* * * * * G * * * * * * * * G * * * * G * * * * * * * * * * * *G/R* * * * *B/O* * * * * * * * * * * * * * * * * *
* * * * G * * * * * * * G * * * G * * * * * * * * * * * * * * * * * * * * * * * * * * * * * * * * * * * * * * * *
* G * G * * * * * * * G * * * * * G * * * G * G * G * G * G * * * * *O/R* * * * * * * * * * * * * * * * * * * * *
* * * * * * * * * * G * * * * * * * * * * * * * * * * * * * * * * * * * * * * * * * * * * * * * * * * * * * * * *
* * * * * * * * * G * * * * * * * * * G * * * * * G * * * * * * O * * * * * R * * * * * * * * * * * * * * * * * *
* * * * * * * * G * * * * * * * * * G * * * * * * * * * * * * * * * * * * * * * * * * * * * * * * * * * * * * * *
* * * * * * * G * * * * * * * * * G * * * * * * * G * * * * O * * * * * * * * * * * * * * * * * * * * * * * * * *
* * * * * * G * * * * * * * * * G * * * * * * * G * * * * * * * * * * * * * * * * * * * * * * * * * * * * * * * *
* * * * * G * * * * * * * * * G * * * * * * * G * * * * O * * * * * * * * * * * R * * * * * * * * * * * * * * * *
* * G * G * * * * * * * * * G * * * * * * * G * * * * * * * * * * * * * * * * * * * * * * * * * * * * * * * * * *
* * * * * * * * * * * * * G * * * * * * * G * * * * O * * * * * * * * * * * * * R * * * * * * * * * * * * * * * *
* * * * * * * * * * * * G * * * * * * * G * * * * * * * * * * * * * * * * * * * * * * * * * * * * * * * * * * * *
* * * * * * * * * * * G * * * * * * * G * * * * O * * * * * * * * * * * * * * * R * * * * * * * * * * * * * * * *
* * * * * * * * * * G * * * * * * * G * * * * * * * * * * * * * * * * * * * * * * * * * * * * * * * * * * * * * *
* * * * * * * * * G * * * * * * * G * * * * O * * * * * * * * * * * * * * * * * * * * * * * * * * * * * * * * * *
* * * * * * G * G * * * * * * * G * * * * * * * * * * * * * * * * * * * * R * * * * * * * * * * * * * * * * * * *
* * * * * * * * * * * * * * * * * * * * O * * * * * * * * * * * * * * * * * * * * * R * * * * * * * * * * * * * *
* * * * * * * * * * * * * * * * * * * * * * * * * * * * * * * * * * * * * R * * * * * * * * * * * * * * * * * * *
* * * * * * * * * * * * * * * * * * O * * * * * * * * * * * * * * * * * * * * * * * * * R * * * * * * * * * * * *
* * * * * * * * * * * * * * * * * * * * * * * * * * * * * * * * * * * * * R * * * * * * * * * * * * * * * * * * *
* * * * * * * * * * * * * * * * O * * * * * * * * * * * * * * * * * * * * * * * * * * * * * R * * * * * * * * * *
* * * * * * * * * * * * * * * * * * * * * * * * * * * * * * * * * * * * * R * * * * * * * * * * * * * * * * * * *
* * * * * * * * * * * * * * O * * * * * * * * * * * * * * * * * * * * * * * * * * * * * * * * * R * * * * * * * *
* * * * * * * * * * * * * * * * * * * * * * * * * * * * * * * * * * * * * R * * * * * * * * * * * * * * * * * * *
* * * * * * * * * * * * * * * * * * * * * * * * * R * R * R * R * R * R * * * * * * * * * * * * R * * * * * * * *
* * * * * * * * * * * * * * * * * * * * * * * * * * * * * * * * * * * * * * * * * * * * * * * * * * * * * * * * *
